11111111111111111111111111111111111
10000000000000000000000000000000001
1000CCC00CC00CCC00CCC00000000000001
1000C000C00C0C0000CE0C0000000000001
10P0CCC0CCC00CCC00C00C0000000000001
1000C000C00C0C0000C00C0000000000001
1000C000C00C0CCC00CCC00000000000001
10000000000000000000000000000000001
11111111111111111111111111111111111