11111111111111111111111
100000000000000000000E1
10110110101011001011101
10101010010010101001001
10101010010010011001001
1P0000000000000000000C1
11111111111111111111111