11111111111111
1P000001000001
1000000100E001
10000001000001
10000001000001
10000000000001
10000000000C01
10000000000001
11111111111111