111111111111111
10000001C000001
1000100100E0001
100010010000001
100010P10000001
100011110000001
10C00000000C001
111111111111111