111111111111111
11000001C000101
10001001000E101
100010010000101
10001P010000011
100011110000001
10C00000000C001
111111111111111