111111111111111
10000001C000001
10001001000E001
100010010000001
100010010000001
100011110000001
10C00000000C001
111111111111111